NO ./texture/42.png 
SO ./texture/glasses.png
WE ./texture/flag_of_malaga.png
EA ./texture/tabacalera.png

C 0,51,102
F 123,63,0

1111111111111
1111001000001
1110011011001
1100111110011
1000001000111
1E00000000001
1111001111111
1111001111111
1111111111111