NO ./texture/cyan.png


SO ./texture/green.png
WE ./texture/purple.png

EA ./texture/yellow.png

C 0,51,102
F 123,63,0




        11111111111111111111111
        10110000011100000000001
        10010000000000100010001
 11111111011000011100000000001
100000000011000000000000001111
111101111111110111000000001
110000000000000000000100001
110000010000000000000000001 
100000000010000000000000001
1000000000000000000000000011111111
11000001110101001000000000000000001
1111011  1110101010000000011111111
1000001 1000000010000000001
1000000100000000000000S0001
100000000000000000000000001
100000010000000000001000001
100000000000000000000000001
100000000000010000000000001
100000000000000000000001001
100000000000000000000000001
100000000000000010000000001
100000001000000000000000001
11111111 11111110111111111111
                1