NO ./texture/door_pink_wall.png
SO ./texture/door_beige_wall.png
WE ./texture/door_red_wall.png
EA ./texture/door_white_infinite.png

C 47,57,40
F 54,46,42



111111111111111111111111111
10000C000000000000000001001
1100011110000000W0000000011
10001100C000000000000000001
100011001000000000000000001
11001000111C111C11000000011
100010001000000001000000001
11001000C000000001000000011
10001111100000000C000000001
110010001000000001000000001
111C111111111C111111C1111C1
1100000C0000000010000000001
100000010000000010000000001
1100000100000000C0000000011
111111111111111111111111111