NO ./texture/forest2.png
SO ./texture/forest3.png
WE ./texture/891397_Dense_forest.png
EA ./texture/forest1.png

C 47,57,40
F 54,46,42



111111111111111111111111111
100000000000000000000000001
110000000100000000000000011
100000000000000000000000001
110000000100000000100000011
100001000000001000000000001
110000000000000000000000011
100000000000000000000001001
1100000000000000W0000000011
100000000000000000000000001
110000001111C11111000000011
100000001000000001000000001
11000000C000000001000000011
10000000100000000C000000001
110000001000000001000000011
1111111111111C1111111111111
110000000000000000000000011
100000000000000000000000001
110000000000000000000000011
111111111111111111111111111