NO ./texture/cyan.png
SO ./texture/green.png
WE ./texture/purple.png
EA ./texture/yellow.png

C 0,51,102
F 123,63,0


1111111
1000001
1001001
1010101
1001001
1010101
1001001
1000001
1001001
1010101
1001001
1010101
1001001
1000001
1001001
1010101
1001001
1010101
1001001
1000001
1001001
1010101
1001001
1010101
1001001
10000N1
1111111