NO ./texture/cyan.png


SO ./texture/green.png
WE ./texture/purple.png

EA ./texture/yellow.png

C 0,51,102
F 123,63,0




11111
100N01
101001
100001
100001
111111
                1