NO ./texture/cyan.png


SO ./texture/green.png
WE ./texture/purple.png

EA ./texture/yellow.png

C 0,51,102
F 123,63,0




111111111111
110011000111
1000000N0111
100001111111
100001
111111
                1