NO ./texture/cyan.png


SO ./texture/green.png
WE ./texture/purple.png

EA ./texture/yellow.png

C 0,51,102
F 123,63,0




  11      1
  111111111111
  110011000111
  100000000111
  100001111111
  110001
  110001   1
  1100N1
  1 1111