NO ./texture/cyan.png
SO ./texture/green.png
WE ./texture/purple.png
EA ./texture/yellow.png

C 0,51,102
F 123,63,0



1111111111111C11111111111111111 10,0		10,1
1000000000000J0000000000001		10,1.5
110000000100000000000000011
100000000000000000000000001
110000000100000000100000011
100001000000001000000000001
110000000000000000000000011
100000000000000000000001001
110000000000000000000000011
100000000000000000000000001
110000001111C11111000000011
100000001000000001000000001
11000000C000000001000000011
10000000100000000C000000001
110000001000000001000000011
1111111111111C1111111111111
110000000000000000000000011
1000000000000N0000000000001
110000000000000000000000011
111111111111111111111111111