NO ./texture/cyan.png


SO ./texture/green.png
WE ./texture/purple.png

EA ./texture/yellow.png

C 0,51,102
F 123,63,0




1111111111111111111111111111111
100000000000000000000000001
110000000000000000000000011
100000000000000000000000001
110000000000000000000000011
100000000000000000000000001
110000000000000000000000011
100000000000000000000000001
110000000000000000000000011
100000000000000000000000001
110000000000000000000000011
100000000000000000000000001
110000000000000000000000011
100000000000000000000000001
110000000000000000000000011
100000000000000000000000001
110000000000000000000000011
1000000000000N0000000000001
110000000000000000000000011
11111111111111111111111111111