NO ./texture/cyan.png


SO ./texture/green.png
WE ./texture/purple.png

EA ./texture/yellow.png

C 0,51,102
F 123,63,0




        1111111111111111111111111
        1011000001110000000000001
        1001000000000010000010001
 1111111101100001110000000000001
10000000001100000000000010001111
11110111111111011100000000001
11000000000000000000010000001
11000001000000000000000000001
10000000001000000000000000001
10000000000000000000000000001
11000001110101001000000000S0111
11110111 11101010100000000001
10000000100000001000000000001
10000000000000000000000000001
10000000000000000000000000001
10000001000000000000100000001
10000000000000000000000000001
10000000000001000000000000001
10000000000000000000000001001
10000000000000000000000000001
10000000000000001000000000001
10000001000000000000000000001
10000000000000000000000100001
10000000100000001000000000001
11111111 1111111 111111111111