NO ./texture/red_brick_wall.png
SO ./texture/pink_wall_and_door.png
WE ./texture/man_pavement_good.png
EA ./texture/43183_door_on_tree.png

C 0,51,102
F 123,63,0

1111111111111111111111111111111
10000000000110111000000001111
1010101010101010101010101011111
11000100001000000000010011000111
10000010010110000111000000N0111
1101000100110000000000000111111
11000000000000000000010001111
10000000000000000000001111111
10000000001000000000000001111111
100000000000000000000100000101011
110001000001111000010000100000011
10000000011   100000000000011111
11000000011    10000000000111111
100000100001111000000000000111
110000010000000000000000001111
100000000000000100000100000111
111111000100000000100000000111
     1000010001000100010000001
111  1000000000000001000101111
101111000000010001000000100001
1100000000100000010000000011111
1010101010101010001010101011111
11111111 1111111011111111111111
                1