NO ./texture/cyan.png


SO ./texture/green.png
WE ./texture/purple.png

EA ./texture/yellow.png

C 0,51,102
F 123,63,0




1111111111111111111111111111111
1010101010101010101010101010101
1100010000010000000000100110001
1000001001011000011100000000001
110100010011000000000000011111
10000E010000110111000000001
110001000000000000000100011
  100000000000000000000001
110000000000000000000000011111
1000000000000000000000000010101
11000000001111000000001000000001
1000000001   100000000000010101
1100000001    1000000000011111
100000000011110000000000001
110000000000000000000000011
100000000000000000001000001
111111000000000000000000011
     1000000010000000000001
11   1000000000000000001011
101111000000000000000000001
110000000000000010000000011
101010101010101000101010101
11111111 11111110111111111111
                1