NO ./texture/cyan.png
SO ./texture/green.png
WE ./texture/purple.png
EA ./texture/yellow.png

C 0,51,102
F 123,63,0


1111111111111111111
101010101C101010101
110000000000000W011
1010101010101010101
1111111111111111111